00 16 41 42 00 16 00 16 40 00 34 21 21 32 16 00 00 22 00 34 21 21 32 18 40
00 00 43 44 16 00 41 42 00 00 45 46 16 34 21 32 16 22 16 00 15 18 34 32 00
41 42 00 00 53 54 43 44 16 18 47 48 00 00 00 34 21 33 49 50 15 00 00 22 00
43 44 00 00 55 56 00 00 00 00 00 00 00 00 00 41 42 00 51 52 15 45 46 22 18
04 00 00 00 00 00 16 00 00 00 00 16 00 00 00 43 44 00 00 00 15 47 48 22 39
09 04 16 00 00 00 00 00 16 00 16 00 00 00 00 00 39 11 01 01 14 00 00 34 32
16 13 01 12 49 50 00 00 00 00 00 00 00 11 01 01 01 14 00 00 00 00 00 39 22
00 00 00 15 51 52 00 00 00 00 11 01 01 14 53 54 00 00 00 00 00 18 49 50 22
41 42 00 13 01 04 00 39 00 00 15 00 00 00 55 56 00 00 18 00 00 00 51 52 22
43 44 18 00 00 10 01 01 03 01 09 01 01 01 01 12 00 00 00 00 00 00 00 00 22
32 00 00 00 40 16 39 00 15 00 00 00 16 00 00 13 12 00 16 16 00 00 00 00 34
34 32 00 18 00 00 53 54 15 00 00 16 00 00 16 00 13 03 01 01 12 00 00 00 02
18 22 00 00 00 00 55 56 15 00 00 53 54 18 00 00 16 15 00 00 13 01 01 01 06
16 22 00 00 40 00 00 00 13 12 00 55 56 00 00 41 42 15 40 41 42 00 00 16 10
16 22 00 00 39 41 42 00 00 13 01 01 01 12 16 43 44 15 00 43 44 00 00 00 18
00 22 00 00 00 43 44 00 00 00 00 00 00 13 01 01 03 14 00 00 40 00 16 00 00
00 22 00 18 16 00 00 39 00 00 00 00 00 00 00 00 15 00 00 16 00 18 00 41 42
00 34 32 00 00 16 00 00 00 16 00 00 00 18 00 00 15 00 00 00 00 00 18 43 44
41 42 34 21 21 21 32 00 00 00 00 16 00 16 00 00 13 01 12 00 18 41 42 18 00
43 44 16 16 00 00 34 21 21 21 21 21 32 00 18 00 16 00 15 00 00 43 44 00 00
